{
	"rowSize": 7,
	"blocks": [
		1, 1, 1, 1, 1, 1, 1,
		1, 0, 2, 0, 2, 0, 1,
		1, 0, 1, 0, 1, 0, 1,
		1, 0, 2, 0, 2, 0, 1,
		1, 0, 1, 2, 1, 0, 1,
		1, 0, 2, 2, 0, 0, 1,
		1, 1, 1, 1, 1, 1, 1
	],
	"spawnPoints": [8, 12, 36, 40]
}