{
	"rowSize": 7,
	"blocks": [
		1, 1, 1, 1, 1, 1, 1,
		1, 0, 0, 0, 0, 0, 1,
		1, 0, 1, 0, 1, 0, 1,
		1, 0, 0, 0, 0, 0, 1,
		1, 0, 1, 0, 1, 0, 1,
		1, 0, 0, 0, 0, 0, 1,
		1, 1, 1, 1, 1, 1, 1
	],
	"spawnPoints": [9, 14, 37, 41]
}